00000002222000000000
00000000002400000000
00002200000300000000
00040022222030000004
00000000002200000000
00000000003022000000
00000000002200000000
00000022030004000000
00004000222222000000
00000000000000222222
00000000000000000000
00000000400300000000
00002220000000000000
00000000000000000000
00000000030000000000
00000300000000000000
00000000022222200000
00000030000000400000
00000000000000000000
00000000000000000040